lemma	gold	hypo	target tag
dadaizmus	dadaizmusoknál	dadaizmusokba	N;IN+ALL;PL
album	albumokként	albumokig	N;FRML;PL
fakopáncs	fakopáncsokig	fakopáncsokként	N;FRML;PL
rakéta	rakétákig	rakétákként	N;FRML;PL
p.	p.-ot	p.-nak	N;DAT;SG
áfonya	áfonyát	áfonyának	N;DAT;SG
zselé	zselékkel	zselékért	N;PRP;PL
oldalág	oldalágakként	oldalágokként	N;FRML;PL
hifi	hifiken	hifieken	N;ON+ESS;PL
környékbeli	környékbeliekben	környékbelikben	N;IN+ESS;PL
évszak	évszaknál	évszakba	N;IN+ALL;SG
földbirtokos	földbirtokosokig	földbirtokosakig	N;TERM;PL
gyémánt	gyémántokig	gyémántokként	N;FRML;PL
facsavar	facsavarhoz	facsavarból	N;IN+ABL;SG
blézer	blézerben	blézeren	N;ON+ESS;SG
basenji	basenjikről	basenjikról	N;ON+ABL;PL
etikus	etikusakká	etikusokká	N;TRANS;PL
perc	percbe	percre	N;ON+ALL;SG
pajesz	pajeszban	pajeszben	N;IN+ESS;SG
tervezés	plural	tervezések	N;NOM;PL
boltkóros	boltkórosokon	boltkórosakon	N;ON+ESS;PL
postaláda	postaládáról	postaládától	N;AT+ABL;SG
bocsát	bocsátani	bocsátni	V;NFIN
tv	tv-ből	tv-hez	N;IN+ABL;SG
visszavesz	visszavettek	visszavesztek	V;IND;PST;INDF;3;PL
vezír	vezírig	vezírré	N;TERM;SG
bárány	báránynál	bárányba	N;IN+ALL;SG
cigaretta	cigarettának	cigarettával	N;INST;SG
varangy	varangyról	varangytól	N;AT+ABL;SG
koktél	koktéllal	koktélért	N;PRP;SG
mell	melleket	mellek	N;ACC;PL
akcióterv	akciótervvel	akciótervel	N;INST;SG
hosszú	hosszúakat	hosszúkat	N;ACC;PL
rendőrség	rendőrségig	rendőrségként	N;FRML;SG
cigaretta	cigarettáért	cigarettává	N;TRANS;SG
forma	formákkal	formákért	N;PRP;PL
válasz	válaszokig	válaszokként	N;FRML;PL
hangszer	hangszeren	hangszernél	N;AT+ESS;SG
opera	operákká	operákig	N;TERM;PL
könny	könnyért	könnnyé	N;TRANS;SG
nyereg	nyerget	nyereget	N;ACC;SG
nádor	nádorokhoz	nádorokból	N;IN+ABL;PL
cinkos	cinkosoknak	cinkosaknak	N;DAT;PL
tegnap	tegnapokra	tegnapokhoz	N;AT+ALL;PL
mező	mezőig	mezőként	N;FRML;SG
amerikai	amerikaivá	amerikaiig	N;TERM;SG
konflis	konflisokra	konflisakra	N;ON+ALL;PL
budapesti	budapestieken	budapestiken	N;ON+ESS;PL
gyógyszerkönyv	gyógyszerkönyvekről	gyógyszerkönyvektől	N;AT+ABL;PL
rendelvény	rendelvényre	rendelvénybe	N;ON+ALL;SG
konténer	konténerből	konténerről	N;ON+ABL;SG
fideszes	fideszest	fideszeset	N;ACC;SG
nyoszolya	nyoszolyában	nyoszolyán	N;ON+ESS;SG
addigi	addigiakba	addigikba	N;IN+ALL;PL
huzat	huzatokból	huzatokról	N;ON+ABL;PL
költségvetés	költségvetésekbe	költségvetésekre	N;ON+ALL;PL
száj	szájakig	szájokig	N;TERM;PL
csaló	csalóval	csalóért	N;PRP;SG
túrós csusza	túrós csuszák	túrós csuszákat	N;ACC;PL
lovász	lovászon	lovászban	N;ON+ESS;SG
csőd	csődökből	csődekből	N;IN+ABL;PL
balhé	balhékért	balhékká	N;TRANS;PL
feladat	feladatokban	feladatokon	N;ON+ESS;PL
tehén	teheneknél	tehéneknél	N;AT+ESS;PL
év	évekért	évekké	N;TRANS;PL
rezervátum	rezervátumokat	rezervátumoknak	N;DAT;PL
karvaly	karvalyból	karvalyról	N;ON+ABL;SG
mez	meznél	mezbe	N;IN+ALL;SG
humor	humoroknál	humorokba	N;IN+ALL;PL
vulkanizmus	vulkanizmusoknak	vulkanizmusokkal	N;INST;PL
nős	nőseken	nősökön	N;ON+ESS;PL
gyónik	gyónnám	gyóniknám	V;COND;PRS;DEF;1;SG
Ft	Ft-ba	Ftra	N;ON+ALL;SG
liget	ligetből	ligetről	N;ON+ABL;SG
tanítványaim	tanítványaimat	tanítványaimot	N;ACC;SG
bocsánat	bocsánatokig	bocsánatokként	N;FRML;PL
szegfű	szegfűkké	szegfűekké	N;TRANS;PL
bocs	bocshoz	bocsból	N;IN+ABL;SG
bőrgyár	bőrgyáraknak	bőrgyároknak	N;DAT;PL
dóm	dómért	dómmá	N;TRANS;SG
ökölharc	ökölharcról	ökölharctól	N;AT+ABL;SG
böjt	böjtökben	böjtekben	N;IN+ESS;PL
dámvad	dámvadakat	dámvadok	N;ACC;PL
isk.	isk.-knak	isk.-ekkel	N;INST;PL
deizmus	deizmuson	deizmusnál	N;AT+ESS;SG
legyőz	legyőznöm	legyőznem	V;NFIN;1;SG
lagúna	lagúnák	lagúnákat	N;ACC;PL
párhuzam	párhuzamokat	párhuzamoknak	N;DAT;PL
forradalom	forradalomból	forradalomhoz	N;IN+ABL;SG
állandóság	állandóságoknál	állandóságokba	N;IN+ALL;PL
panamakalap	panamakalapra	panamakalaphoz	N;AT+ALL;SG
dallam	dallamokról	dallamoktól	N;AT+ABL;PL
áprilisi	áprilisiakká	áprilisiekké	N;TRANS;PL
bodza	bodzáknak	bodzákkal	N;INST;PL
gyár	gyáraknak	gyárokkal	N;INST;PL
stabil	stabilakból	stabilokból	N;IN+ABL;PL
virágcserép	virágcserepet	virágcserépnek	N;DAT;SG
magyal	magyalon	magyalban	N;ON+ESS;SG
ismeretlen	ismeretlenhez	ismeretlenből	N;IN+ABL;SG
mari	mariknál	mariaknál	N;AT+ESS;PL
dölyf	dölyfökön	dölyfekben	N;ON+ESS;PL
billentyű	billentyűkké	billentyűekig	N;TERM;PL
robotos	robotosokká	robotosakká	N;TRANS;PL
alatti	alattiakért	alattikért	N;PRP;PL
adatlap	adatlapot	adatlap	N;ACC;SG
problémás	problémásakból	problémásokból	N;IN+ABL;PL
tanti	tantikig	tantikként	N;FRML;PL
ismert	ismertekbe	ismerteknél	N;IN+ALL;PL
változás	változásokká	változásokig	N;TERM;PL
gyűrű	gyűrűben	gyűrűn	N;ON+ESS;SG
banya	banyával	banyáért	N;PRP;SG
betyár	betyárrá	betyárig	N;TERM;SG
alkar	alkarért	alkarrá	N;TRANS;SG
földrengés	földrengésre	földrengéshez	N;AT+ALL;SG
cipész	cipészekért	cipészekké	N;TRANS;PL
bizonyítás	bizonyításokat	bizonyításoknak	N;DAT;PL
demokrácia	demokráciából	demokráciáról	N;ON+ABL;SG
hidegháború	hidegháborúnál	hidegháborúba	N;IN+ALL;SG
biofizika	plural	biofizikák	N;NOM;PL
karácsonyéj	karácsonyéjektől	karácsonyéjoktól	N;AT+ABL;PL
rajong	rajongta	rajongotta	V;IND;PST;DEF;3;SG
heverő	singular	heverő	N;NOM;SG
baleset	baleseteken	balesetekben	N;ON+ESS;PL
homeosztázis	homeosztázisoknak	homeosztázisaknak	N;DAT;PL
összeszed	összeszedett	összeszedt	V;IND;PST;INDF;3;SG
zsákutca	zsákutcát	zsákutcának	N;DAT;SG
vagdos	vagdossa	vagdosja	V;IND;PRS;DEF;3;SG
műholdas	műholdasakká	műholdasokká	N;TRANS;PL
mészkő	mészkövekké	mészkőkké	N;TRANS;PL
deista	deistákká	deistákig	N;TERM;PL
rész	részül	részben	N;IN+ESS;SG
